mimmmgmhmnmgltff		kngqlrighglqggjh
mimmmgmhmnmgltfg		kngqlrighglqggjp
mimmmgmhmnmgltfh		kngqlrighglqggio
mimmmgmhmnmgltfi		kngqlrighglqgghm
mimmmgmhmnmgltfj		kngqlrighglqggmo
mimmmgmhmnmgltfk		kngqlrighglqggkg
mimmmgmhmnmgltfl		kngqlrighglqggiq
mimmmgmhmnmgltfm		kngqlrighglqggfj
mimmmgmhmnmgltfn		kngqlrighglqggkp
mimmmgmhmnmgltfo		kngqlrighglqggjl
mimmmgmhmnmgltfp		kngqlrighglqggko
mimmmgmhmnmgltfq		kngqlrighglqggip
mimmmgmhmnmgltfr		kngqlrighglqggjs
mimmmgmhmnmgltfs		kngqlrighglqggik
mimmmgmhmnmgltft		kngqlrighglqgglt
mimmmgmhmnmgltfu		kngqlrighglqgghh
mimmmgmhmnmgltgf		kngqlrighglqggmr
mimmmgmhmnmgltgg		kngqlrighglqggls
mimmmgmhmnmgltgh		kngqlrighglqggmu
mimmmgmhmnmgltgi		kngqlrighglqgggl
mimmmgmhmnmgltgj		kngqlrighglqgggi
mimmmgmhmnmgltgk		kngqlrighglqggmg
mimmmgmhmnmgltgl		kngqlrighglqggfk
mimmmgmhmnmgltgm		kngqlrighglqggih
mimmmgmhmnmgltgn		kngqlrighglqggki
mimmmgmhmnmgltgo		kngqlrighglqgglu
mimmmgmhmnmgltgp		kngqlrighglqgggn
mimmmgmhmnmgltgq		kngqlrighglqggff
mimmmgmhmnmgltgr		kngqlrighglqggkm
mimmmgmhmnmgltgs		kngqlrighglqgghu
mimmmgmhmnmgltgt		kngqlrighglqggis
mimmmgmhmnmgltgu		kngqlrighglqggfl
mimmmgmhmnmglthf		kngqlrighglqgglq
mimmmgmhmnmglthg		kngqlrighglqgggk
mimmmgmhmnmglthh		kngqlrighglqggmp
mimmmgmhmnmglthi		kngqlrighglqgggj
mimmmgmhmnmglthj		kngqlrighglqggkf
mimmmgmhmnmglthk		kngqlrighglqgght
mimmmgmhmnmglthl		kngqlrighglqgggq
mimmmgmhmnmglthm		kngqlrighglqggkl
mimmmgmhmnmglthn		kngqlrighglqggmj
mimmmgmhmnmgltho		kngqlrighglqggmn
mimmmgmhmnmglthp		kngqlrighglqggmm
mimmmgmhmnmglthq		kngqlrighglqggjg
mimmmgmhmnmglthr		kngqlrighglqggll
mimmmgmhmnmglths		kngqlrighglqggjj
mimmmgmhmnmgltht		kngqlrighglqgghi
mimmmgmhmnmglthu		kngqlrighglqggkh
mimmmgmhmnmgltif		kngqlrighglqggku
mimmmgmhmnmgltig		kngqlrighglqgghl
mimmmgmhmnmgltih		kngqlrighglqggkq
mimmmgmhmnmgltii		kngqlrighglqggmh
mimmmgmhmnmgltij		kngqlrighglqggfu
mimmmgmhmnmgltik		kngqlrighglqgghn
mimmmgmhmnmgltil		kngqlrighglqggiu
mimmmgmhmnmgltim		kngqlrighglqggjm
mimmmgmhmnmgltin		kngqlrighglqgglr
mimmmgmhmnmgltio		kngqlrighglqggji
mimmmgmhmnmgltip		kngqlrighglqggfp
mimmmgmhmnmgltiq		kngqlrighglqgglp
mimmmgmhmnmgltir		kngqlrighglqggjt
mimmmgmhmnmgltis		kngqlrighglqgglh
mimmmgmhmnmgltit		kngqlrighglqgghs
mimmmgmhmnmgltiu		kngqlrighglqggfq
mimmmgmhmnmgltjf		kngqlrighglqggij
mimmmgmhmnmgltjg		kngqlrighglqggfn
mimmmgmhmnmgltjh		kngqlrighglqggjk
mimmmgmhmnmgltji		kngqlrighglqggjr
mimmmgmhmnmgltjj		kngqlrighglqggim
mimmmgmhmnmgltjk		kngqlrighglqgggs
mimmmgmhmnmgltjl		kngqlrighglqggho
mimmmgmhmnmgltjm		kngqlrighglqgggr
mimmmgmhmnmgltjn		kngqlrighglqggfm
mimmmgmhmnmgltjo		kngqlrighglqggmi
mimmmgmhmnmgltjp		kngqlrighglqgghj
mimmmgmhmnmgltjq		kngqlrighglqgglk
mimmmgmhmnmgltjr		kngqlrighglqggms
mimmmgmhmnmgltjs		kngqlrighglqggii
mimmmgmhmnmgltjt		kngqlrighglqggif
mimmmgmhmnmgltju		kngqlrighglqgghq
mimmmgmhmnmgltkf		kngqlrighglqggmk
mimmmgmhmnmgltkg		kngqlrighglqgggo
mimmmgmhmnmgltkh		kngqlrighglqggkj
mimmmgmhmnmgltki		kngqlrighglqggks
mimmmgmhmnmgltkj		kngqlrighglqgghk
mimmmgmhmnmgltkk		kngqlrighglqgggp
mimmmgmhmnmgltkl		kngqlrighglqggin
mimmmgmhmnmgltkm		kngqlrighglqgglj
mimmmgmhmnmgltkn		kngqlrighglqggfr
mimmmgmhmnmgltko		kngqlrighglqggit
mimmmgmhmnmgltkp		kngqlrighglqggjn
mimmmgmhmnmgltkq		kngqlrighglqgghp
mimmmgmhmnmgltkr		kngqlrighglqgggu
mimmmgmhmnmgltks		kngqlrighglqgghg
mimmmgmhmnmgltkt		kngqlrighglqggjq
mimmmgmhmnmgltku		kngqlrighglqgglo
mimmmgmhmnmgltlf		kngqlrighglqggfh
mimmmgmhmnmgltlg		kngqlrighglqggkk
mimmmgmhmnmgltlh		kngqlrighglqgggg
mimmmgmhmnmgltli		kngqlrighglqggml
mimmmgmhmnmgltlj		kngqlrighglqggjo
mimmmgmhmnmgltlk		kngqlrighglqgggt
mimmmgmhmnmgltll		kngqlrighglqgglg
mimmmgmhmnmgltlm		kngqlrighglqggft
mimmmgmhmnmgltln		kngqlrighglqggfs
mimmmgmhmnmgltlo		kngqlrighglqgglm
mimmmgmhmnmgltlp		kngqlrighglqgggf
mimmmgmhmnmgltlq		kngqlrighglqggfo
mimmmgmhmnmgltlr		kngqlrighglqggkr
mimmmgmhmnmgltls		kngqlrighglqggmf
mimmmgmhmnmgltlt		kngqlrighglqggmt
mimmmgmhmnmgltlu		kngqlrighglqggli
mimmmgmhmnmgltmf		kngqlrighglqggir
mimmmgmhmnmgltmg		kngqlrighglqggjf
mimmmgmhmnmgltmh		kngqlrighglqggig
mimmmgmhmnmgltmi		kngqlrighglqggfi
mimmmgmhmnmgltmj		kngqlrighglqggju
mimmmgmhmnmgltmk		kngqlrighglqggmq
mimmmgmhmnmgltml		kngqlrighglqggln
mimmmgmhmnmgltmm		kngqlrighglqggil
mimmmgmhmnmgltmn		kngqlrighglqggkn
mimmmgmhmnmgltmo		kngqlrighglqgggh
mimmmgmhmnmgltmp		kngqlrighglqgghr
mimmmgmhmnmgltmq		kngqlrighglqggkt
mimmmgmhmnmgltmr		kngqlrighglqgggm
mimmmgmhmnmgltms		kngqlrighglqgghf
mimmmgmhmnmgltmt		kngqlrighglqgglf
mimmmgmhmnmgltmu		kngqlrighglqggfg
