mimmmgmhffffffff		kngqlrigjkmshkmo
mimmmgmhfgffffff		kngqlrigjifgmigp
mimmmgmhfhffffff		kngqlrigjtlmglhh
mimmmgmhfiffffff		kngqlrigifgrhphq
mimmmgmhfjffffff		kngqlrigiojnkkmf
mimmmgmhfkffffff		kngqlriggsfukslu
mimmmgmhflffffff		kngqlrigglglgqgj
mimmmgmhfmffffff		kngqlrigghltmqff
mimmmgmhfnffffff		kngqlriggqkrgrjj
mimmmgmhfoffffff		kngqlriggkmtjjhj
mimmmgmhfpffffff		kngqlrigjhljiljp
mimmmgmhfqffffff		kngqlrigfmiohffu
mimmmgmhfrffffff		kngqlrigjgfkhrfu
mimmmgmhfsffffff		kngqlriglqiiijhn
mimmmgmhftffffff		kngqlriglnhqmskh
mimmmgmhfuffffff		kngqlriggmfskfjt
mimmmgmhgfffffff		kngqlrigkskjhifn
mimmmgmhggffffff		kngqlrigkljhhmis
mimmmgmhghffffff		kngqlrighnlkigmm
mimmmgmhgiffffff		kngqlrigitgqkqmj
mimmmgmhgjffffff		kngqlrigfqlmimgg
mimmmgmhgkffffff		kngqlriglthgiimu
mimmmgmhglffffff		kngqlrigfnislkhr
mimmmgmhgmffffff		kngqlrigmlhofhgs
mimmmgmhgnffffff		kngqlrigknmimphi
mimmmgmhgoffffff		kngqlrigkjipjkgr
mimmmgmhgpffffff		kngqlrigismgmpmu
mimmmgmhgqffffff		kngqlrigmqlmkpgn
mimmmgmhgrffffff		kngqlrigmrhulilt
mimmmgmhgsffffff		kngqlriglmhlisii
mimmmgmhgtffffff		kngqlrigfuggktgj
mimmmgmhguffffff		kngqlrigkofmlthf
mimmmgmhhfffffff		kngqlrigljigfkgr
mimmmgmhhgffffff		kngqlrigkfhjkmmt
mimmmgmhhhffffff		kngqlrigmufgjmkn
mimmmgmhhiffffff		kngqlrigfojihtmo
mimmmgmhhjffffff		kngqlrighsirmtls
mimmmgmhhkffffff		kngqlrigguikgphj
mimmmgmhhlffffff		kngqlrigmjhjihgs
mimmmgmhhmffffff		kngqlrigmgigitgf
mimmmgmhhnffffff		kngqlrighufkkqkg
mimmmgmhhoffffff		kngqlriggnmpfnli
mimmmgmhhpffffff		kngqlrigfgkojumq
mimmmgmhhqffffff		kngqlrigjohmfkht
mimmmgmhhrffffff		kngqlrigmoftkjml
mimmmgmhhsffffff		kngqlrigfsisitkk
mimmmgmhhtffffff		kngqlriginlplmgi
mimmmgmhhuffffff		kngqlriglufojhmh
mimmmgmhifffffff		kngqlrigftmtfukn
mimmmgmhigffffff		kngqlrigmfftfhmj
mimmmgmhihffffff		kngqlriglimrjmfq
mimmmgmhiiffffff		kngqlrigiikjglgf
mimmmgmhijffffff		kngqlrighrhmmfik
mimmmgmhikffffff		kngqlrigjpfrgrhj
mimmmgmhilffffff		kngqlriglglshrmh
mimmmgmhimffffff		kngqlrigkujjfjgq
mimmmgmhinffffff		kngqlrigmsmufmit
mimmmgmhioffffff		kngqlriggohhikfg
mimmmgmhipffffff		kngqlrighmlslsmp
mimmmgmhiqffffff		kngqlriggrgqfklf
mimmmgmhirffffff		kngqlrigkiiihhfo
mimmmgmhisffffff		kngqlrighhmmkfin
mimmmgmhitffffff		kngqlrigmtgkhtip
mimmmgmhiuffffff		kngqlrigjnjrfrgr
mimmmgmhjfffffff		kngqlrigktmmlihp
mimmmgmhjgffffff		kngqlriglogkfllp
mimmmgmhjhffffff		kngqlrigfrmohrfq
mimmmgmhjiffffff		kngqlrigfpmujjlk
mimmmgmhjjffffff		kngqlrigjuikfsin
mimmmgmhjkffffff		kngqlrighikgknkn
mimmmgmhjlffffff		kngqlrigmnfpkpgg
mimmmgmhjmffffff		kngqlriglhiqfnmh
mimmmgmhjnffffff		kngqlrighojnfjmi
mimmmgmhjoffffff		kngqlrigjmgjkmgi
mimmmgmhjpffffff		kngqlrigighnlrfr
mimmmgmhjqffffff		kngqlrighphlkjlq
mimmmgmhjrffffff		kngqlrigmkmmfomm
mimmmgmhjsffffff		kngqlriglfithflj
mimmmgmhjtffffff		kngqlrigflkmflmj
mimmmgmhjuffffff		kngqlrigkrhqgqml
mimmmgmhkfffffff		kngqlrigijmflrik
mimmmgmhkgffffff		kngqlriglklshnjk
mimmmgmhkhffffff		kngqlrigfjhfftmk
mimmmgmhkiffffff		kngqlrigjqkffokr
mimmmgmhkjffffff		kngqlrigjlklinlm
mimmmgmhkkffffff		kngqlrigmilrmsht
mimmmgmhklffffff		kngqlrigfigflqkp
mimmmgmhkmffffff		kngqlrighjkokpjm
mimmmgmhknffffff		kngqlrigkgjqjpmn
mimmmgmhkoffffff		kngqlrigmminmojg
mimmmgmhkpffffff		kngqlrigimgokjli
mimmmgmhkqffffff		kngqlrigjsjllfhm
mimmmgmhkrffffff		kngqlrigmhhnguhp
mimmmgmhksffffff		kngqlrigiuhgfigp
mimmmgmhktffffff		kngqlrigfhhjhqft
mimmmgmhkuffffff		kngqlrighkhhmglj
mimmmgmhlfffffff		kngqlrigjjljjkfg
mimmmgmhlgffffff		kngqlriggigmhjmh
mimmmgmhlhffffff		kngqlrigmplnjmin
mimmmgmhliffffff		kngqlriggplfgtiu
mimmmgmhljffffff		kngqlrighqhsifmj
mimmmgmhlkffffff		kngqlriggtikghfk
mimmmgmhllffffff		kngqlrigkhhnlqlq
mimmmgmhlmffffff		kngqlrigggknlsir
mimmmgmhlnffffff		kngqlrigkqhljhmj
mimmmgmhloffffff		kngqlrighlijgigq
mimmmgmhlpffffff		kngqlrigiljfkulj
mimmmgmhlqffffff		kngqlrigihlrkigp
mimmmgmhlrffffff		kngqlrigkmjoimkq
mimmmgmhlsffffff		kngqlriggjjjmmlh
mimmmgmhltffffff		kngqlrigkkkpmhmh
mimmmgmhluffffff		kngqlrigirlkmrku
mimmmgmhmfffffff		kngqlrigjrjrhllf
mimmmgmhmgffffff		kngqlrigffkflfin
mimmmgmhmhffffff		kngqlriglphhjfll
mimmmgmhmiffffff		kngqlriglrligrju
mimmmgmhmjffffff		kngqlriglshhjifu
mimmmgmhmkffffff		kngqlrigjfkijuik
mimmmgmhmlffffff		kngqlrigikgugiml
mimmmgmhmmffffff		kngqlrigfkgshnit
mimmmgmhmnffffff		kngqlrighgkllhhn
mimmmgmhmoffffff		kngqlriggffpimmt
mimmmgmhmpffffff		kngqlrighffhjjlt
mimmmgmhmqffffff		kngqlrigiqlfkhht
mimmmgmhmrffffff		kngqlrightfllhmo
mimmmgmhmsffffff		kngqlrigipmkikig
mimmmgmhmtffffff		kngqlrigkpgnjijp
mimmmgmhmuffffff		kngqlrigllkfknho
