mimmmgmhmnffffff		kngqlrighgkllhhn
mimmmgmhmnfgffff		kngqlrighgfmkmlg
mimmmgmhmnfhffff		kngqlrighghsmilr
mimmmgmhmnfiffff		kngqlrighgmufmkk
mimmmgmhmnfjffff		kngqlrighgmglmhn
mimmmgmhmnfkffff		kngqlrighgkmgulf
mimmmgmhmnflffff		kngqlrighgisjmgk
mimmmgmhmnfmffff		kngqlrighgjrltis
mimmmgmhmnfnffff		kngqlrighghkkrjr
mimmmgmhmnfoffff		kngqlrighgkqkrfm
mimmmgmhmnfpffff		kngqlrighgjshgkr
mimmmgmhmnfqffff		kngqlrighglkklmp
mimmmgmhmnfrffff		kngqlrighglihhjj
mimmmgmhmnfsffff		kngqlrighghijjfm
mimmmgmhmnftffff		kngqlrighglmjnjp
mimmmgmhmnfuffff		kngqlrighgknffmn
mimmmgmhmngfffff		kngqlrighgmhisjl
mimmmgmhmnggffff		kngqlrighghrjugu
mimmmgmhmnghffff		kngqlrighgmokikr
mimmmgmhmngiffff		kngqlrighggukufh
mimmmgmhmngjffff		kngqlrighgjilqjs
mimmmgmhmngkffff		kngqlrighgkgkiji
mimmmgmhmnglffff		kngqlrighgggggir
mimmmgmhmngmffff		kngqlrighghfjrfn
mimmmgmhmngnffff		kngqlrighgfrlikf
mimmmgmhmngoffff		kngqlrighglnlhji
mimmmgmhmngpffff		kngqlrighgjoikkr
mimmmgmhmngqffff		kngqlrighglffrjg
mimmmgmhmngrffff		kngqlrighgjqkjfh
mimmmgmhmngsffff		kngqlrighgktfjjs
mimmmgmhmngtffff		kngqlrighghqfsfp
mimmmgmhmnguffff		kngqlrighgjhjpgr
mimmmgmhmnhfffff		kngqlrighghjglhf
mimmmgmhmnhgffff		kngqlrighgkrkmin
mimmmgmhmnhhffff		kngqlrighghngjhl
mimmmgmhmnhiffff		kngqlrighggifrmi
mimmmgmhmnhjffff		kngqlrighghgjugh
mimmmgmhmnhkffff		kngqlrighgmkimmh
mimmmgmhmnhlffff		kngqlrighgijilig
mimmmgmhmnhmffff		kngqlrighglllnmh
mimmmgmhmnhnffff		kngqlrighggnmlhi
mimmmgmhmnhoffff		kngqlrighggsjkjf
mimmmgmhmnhpffff		kngqlrighgfgkkml
mimmmgmhmnhqffff		kngqlrighgipjnmm
mimmmgmhmnhrffff		kngqlrighgjukkjr
mimmmgmhmnhsffff		kngqlrighgjjjrls
mimmmgmhmnhtffff		kngqlrighgltftgp
mimmmgmhmnhuffff		kngqlrighghohkim
mimmmgmhmnifffff		kngqlrighgkoliho
mimmmgmhmnigffff		kngqlrighgjtkihs
mimmmgmhmnihffff		kngqlrighgmnmhir
mimmmgmhmniiffff		kngqlrighgmphmhn
mimmmgmhmnijffff		kngqlrighggojqfr
mimmmgmhmnikffff		kngqlrighgkpksfp
mimmmgmhmnilffff		kngqlrighggqmkin
mimmmgmhmnimffff		kngqlrighgfukumh
mimmmgmhmninffff		kngqlrighgiompkn
mimmmgmhmnioffff		kngqlrighglumgfn
mimmmgmhmnipffff		kngqlrighgjmhois
mimmmgmhmniqffff		kngqlrighgkfkhhh
mimmmgmhmnirffff		kngqlrighgfqkfir
mimmmgmhmnisffff		kngqlrighgmtfgln
mimmmgmhmnitffff		kngqlrighggtknkt
mimmmgmhmniuffff		kngqlrighgfnlpff
mimmmgmhmnjfffff		kngqlrighgkkjgli
mimmmgmhmnjgffff		kngqlrighgflhnhs
mimmmgmhmnjhffff		kngqlrighgljfjgu
mimmmgmhmnjiffff		kngqlrighgjgmlgp
mimmmgmhmnjjffff		kngqlrighgiqiufm
mimmmgmhmnjkffff		kngqlrighgfsfpgq
mimmmgmhmnjlffff		kngqlrighggpfglm
mimmmgmhmnjmffff		kngqlrighgifihjq
mimmmgmhmnjnffff		kngqlrighgfjmplq
mimmmgmhmnjoffff		kngqlrighglgjpkt
mimmmgmhmnjpffff		kngqlrighgkhfjmg
mimmmgmhmnjqffff		kngqlrighgfhkrfg
mimmmgmhmnjrffff		kngqlrighgmsgnhl
mimmmgmhmnjsffff		kngqlrighggflnho
mimmmgmhmnjtffff		kngqlrighgfogtir
mimmmgmhmnjuffff		kngqlrighgikhqmj
mimmmgmhmnkfffff		kngqlrighgghmgig
mimmmgmhmnkgffff		kngqlrighgksjsio
mimmmgmhmnkhffff		kngqlrighghtkkkp
mimmmgmhmnkiffff		kngqlrighghmlrlk
mimmmgmhmnkjffff		kngqlrighglokhlf
mimmmgmhmnkkffff		kngqlrighgjnmfjf
mimmmgmhmnklffff		kngqlrighgmfmrkq
mimmmgmhmnkmffff		kngqlrighgkihmlf
mimmmgmhmnknffff		kngqlrighgkjjokg
mimmmgmhmnkoffff		kngqlrighghpinjs
mimmmgmhmnkpffff		kngqlrighglrlpiq
mimmmgmhmnkqffff		kngqlrighgigfpgj
mimmmgmhmnkrffff		kngqlrighgfpfrki
mimmmgmhmnksffff		kngqlrighgjlgmit
mimmmgmhmnktffff		kngqlrighgftgskj
mimmmgmhmnkuffff		kngqlrighgmrjtlu
mimmmgmhmnlfffff		kngqlrighgimklfq
mimmmgmhmnlgffff		kngqlrighggjgijl
mimmmgmhmnlhffff		kngqlrighggrmhff
mimmmgmhmnliffff		kngqlrighgilfijg
mimmmgmhmnljffff		kngqlrighgiiiqkg
mimmmgmhmnlkffff		kngqlrighgingnll
mimmmgmhmnllffff		kngqlrighgmmkifs
mimmmgmhmnlmffff		kngqlrighgmihnkj
mimmmgmhmnlnffff		kngqlrighgjklnkq
mimmmgmhmnloffff		kngqlrighgglguip
mimmmgmhmnlpffff		kngqlrighglshskq
mimmmgmhmnlqffff		kngqlrighgjflfgl
mimmmgmhmnlrffff		kngqlrighgiugtlq
mimmmgmhmnlsffff		kngqlrighgmlgufh
mimmmgmhmnltffff		kngqlrighglhmjkt
mimmmgmhmnluffff		kngqlrighggmihhn
mimmmgmhmnmfffff		kngqlrighgjpgqgk
mimmmgmhmnmgffff		kngqlrighglqmolo
mimmmgmhmnmhffff		kngqlrighgkuknln
mimmmgmhmnmiffff		kngqlrighgmqhrmt
mimmmgmhmnmjffff		kngqlrighgmjiqmm
mimmmgmhmnmkffff		kngqlrighghhhrjp
mimmmgmhmnmlffff		kngqlrighghljrit
mimmmgmhmnmmffff		kngqlrighggkfqli
mimmmgmhmnmnffff		kngqlrighgffkqmp
mimmmgmhmnmoffff		kngqlrighglplrfs
mimmmgmhmnmpffff		kngqlrighgfkhglq
mimmmgmhmnmqffff		kngqlrighgihgsik
mimmmgmhmnmrffff		kngqlrighgfihsff
mimmmgmhmnmsffff		kngqlrighgirlpkm
mimmmgmhmnmtffff		kngqlrighgitjjih
mimmmgmhmnmuffff		kngqlrighghulikn
