mimmmgffffffffff		kngqlrfufujkftgo
mimmmgfgffffffff		kngqlrgsltisklmk
mimmmgfhffffffff		kngqlrmthjkskmhr
mimmmgfiffffffff		kngqlrktfrilmrjs
mimmmgfjffffffff		kngqlrhuhmimfmgp
mimmmgfkffffffff		kngqlrfshigtihmp
mimmmgflffffffff		kngqlrmngrmjhpmh
mimmmgfmffffffff		kngqlrmfmtjmlmft
mimmmgfnffffffff		kngqlrhrhihmgpmg
mimmmgfoffffffff		kngqlrlklphilfmp
mimmmgfpffffffff		kngqlrkufhfrgkll
mimmmgfqffffffff		kngqlrmsltfgjrji
mimmmgfrffffffff		kngqlrljkngphofq
mimmmgfsffffffff		kngqlrlnitiufpir
mimmmgftffffffff		kngqlrgnismjlfkn
mimmmgfuffffffff		kngqlrijimghmuln
mimmmggfffffffff		kngqlrlsgliigmfi
mimmmgggffffffff		kngqlrllmrljknlj
mimmmgghffffffff		kngqlrfgmhmgkpfj
mimmmggiffffffff		kngqlrkfkijuismi
mimmmggjffffffff		kngqlrggggfigtfs
mimmmggkffffffff		kngqlrkslggpiugg
mimmmgglffffffff		kngqlrkqglijfsmo
mimmmggmffffffff		kngqlrjljsfujrgm
mimmmggnffffffff		kngqlrgoipjllsfs
mimmmggoffffffff		kngqlriqlompjoig
mimmmggpffffffff		kngqlrjmkrffighm
mimmmggqffffffff		kngqlrikgmlmjkgs
mimmmggrffffffff		kngqlrflkrmsfjfn
mimmmggsffffffff		kngqlrjgfhjkgofu
mimmmggtffffffff		kngqlrglkumqjqjl
mimmmgguffffffff		kngqlrfnhgfgljhs
mimmmghfffffffff		kngqlrhnlullhljf
mimmmghgffffffff		kngqlrlfiqjsgmjs
mimmmghhffffffff		kngqlrfhgjjsgpiq
mimmmghiffffffff		kngqlrhkkqgkiqhq
mimmmghjffffffff		kngqlringpjghfll
mimmmghkffffffff		kngqlrlukngmgtgm
mimmmghlffffffff		kngqlrfpitmighgf
mimmmghmffffffff		kngqlrfrhflojphn
mimmmghnffffffff		kngqlrlghmlhgtfi
mimmmghoffffffff		kngqlrkkmhkmmrkq
mimmmghpffffffff		kngqlrmqfjjlgumf
mimmmghqffffffff		kngqlrgrgoffkkji
mimmmghrffffffff		kngqlrhfgmmlmpks
mimmmghsffffffff		kngqlrlrkqhiitfl
mimmmghtffffffff		kngqlrmhkpingphf
mimmmghuffffffff		kngqlrkjhummfghn
mimmmgifffffffff		kngqlrlihpkmlfln
mimmmgigffffffff		kngqlritkmgujskh
mimmmgihffffffff		kngqlrgqiplslukp
mimmmgiiffffffff		kngqlriumjkjjofs
mimmmgijffffffff		kngqlrgmgnfohnlh
mimmmgikffffffff		kngqlrjrfhgfggjf
mimmmgilffffffff		kngqlrgughgkgmkq
mimmmgimffffffff		kngqlrifhhihihmg
mimmmginffffffff		kngqlrjofifhkukl
mimmmgioffffffff		kngqlrjfjulkksht
mimmmgipffffffff		kngqlrhmknigfkkt
mimmmgiqffffffff		kngqlrhtgoffgfjs
mimmmgirffffffff		kngqlrfiiqltkgfq
mimmmgisffffffff		kngqlrkmhjgolqhu
mimmmgitffffffff		kngqlrlmhghfmmmn
mimmmgiuffffffff		kngqlrgkfimmhjmt
mimmmgjfffffffff		kngqlrhjhugrltir
mimmmgjgffffffff		kngqlripjrfpjiff
mimmmgjhffffffff		kngqlrkigjjlktki
mimmmgjiffffffff		kngqlrjpmlhkmnfm
mimmmgjjffffffff		kngqlrhpimkkiumr
mimmmgjkffffffff		kngqlriojfhifnml
mimmmgjlffffffff		kngqlrisfuljhnmf
mimmmgjmffffffff		kngqlrhifllrktfo
mimmmgjnffffffff		kngqlrlqfrjmjthp
mimmmgjoffffffff		kngqlrmpijlijrkj
mimmmgjpffffffff		kngqlrmuhogqjthp
mimmmgjqffffffff		kngqlrjifoljfrkm
mimmmgjrffffffff		kngqlrhljsmnfsjj
mimmmgjsffffffff		kngqlrgilnkignht
mimmmgjtffffffff		kngqlrknkohjfffp
mimmmgjuffffffff		kngqlrhhifhjhrin
mimmmgkfffffffff		kngqlrftjqfkltkf
mimmmgkgffffffff		kngqlriijgjqhfhr
mimmmgkhffffffff		kngqlrkllmgiklgt
mimmmgkiffffffff		kngqlrgtffghgtkl
mimmmgkjffffffff		kngqlrfmmkjulrfu
mimmmgkkffffffff		kngqlrjugnitkgmf
mimmmgklffffffff		kngqlrkgihkskkjo
mimmmgkmffffffff		kngqlrkoiploikmi
mimmmgknffffffff		kngqlrjhiokqgkjm
mimmmgkoffffffff		kngqlrjqmfmmgqgm
mimmmgkpffffffff		kngqlrjnlphqkmhq
mimmmgkqffffffff		kngqlrkrkthugrih
mimmmgkrffffffff		kngqlrmggsffikgi
mimmmgksffffffff		kngqlrilhrkhiojn
mimmmgktffffffff		kngqlrgplihfiqkg
mimmmgkuffffffff		kngqlrjjlfkgirhs
mimmmglfffffffff		kngqlrmoilfrlngo
mimmmglgffffffff		kngqlrhqfsiplgih
mimmmglhffffffff		kngqlrjsmlfgijip
mimmmgliffffffff		kngqlrfjmsfnhmmm
mimmmgljffffffff		kngqlrkphoikkggs
mimmmglkffffffff		kngqlrmjktmqjnfl
mimmmgllffffffff		kngqlrfffumlhsmo
mimmmglmffffffff		kngqlrmrjtinlfis
mimmmglnffffffff		kngqlrjtlhiskfkt
mimmmgloffffffff		kngqlrhogthhlgfh
mimmmglpffffffff		kngqlrlogjmjgfgk
mimmmglqffffffff		kngqlrmkgkgsfnlu
mimmmglrffffffff		kngqlrmigpjsfpmh
mimmmglsffffffff		kngqlrkhgqfrjfjj
mimmmgltffffffff		kngqlrmljfmsffhs
mimmmgluffffffff		kngqlrlpkhfslpku
mimmmgmfffffffff		kngqlrfkjkfqihhp
mimmmgmgffffffff		kngqlrimksgghohn
mimmmgmhffffffff		kngqlrigjkmshkmo
mimmmgmiffffffff		kngqlrgjjgmhjkgl
mimmmgmjffffffff		kngqlririrftgqho
mimmmgmkffffffff		kngqlrlhmulmgmll
mimmmgmlffffffff		kngqlrmmisjmlmhg
mimmmgmmffffffff		kngqlrlthkjkkogi
mimmmgmnffffffff		kngqlrfqlrfpjmmr
mimmmgmoffffffff		kngqlrhsgjggggkq
mimmmgmpffffffff		kngqlrgfhkkmmrim
mimmmgmqffffffff		kngqlrghlpijiqkq
mimmmgmrffffffff		kngqlrhgkgfsihji
mimmmgmsffffffff		kngqlrfoilfijkht
mimmmgmtffffffff		kngqlrjkjhgkjuhu
mimmmgmuffffffff		kngqlrihlogtiuls
