mimmffffffffffff		kngqgqigimkufuii
mimmfgffffffffff		kngqjnjsjuhnjqfi
mimmfhffffffffff		kngqiqmfihhkfohf
mimmfiffffffffff		kngqmhjplgmplgmj
mimmfjffffffffff		kngqmpijgklpfghk
mimmfkffffffffff		kngqhulpjjguiqkq
mimmflffffffffff		kngqjllujpglkklp
mimmfmffffffffff		kngqhklsgriqksgr
mimmfnffffffffff		kngqkpiqiflriigr
mimmfoffffffffff		kngqmklokfirfqlm
mimmfpffffffffff		kngqktlgjifihkht
mimmfqffffffffff		kngqjignfmlgjgfp
mimmfrffffffffff		kngqmfhglgghiols
mimmfsffffffffff		kngqklgqkojmiqfp
mimmftffffffffff		kngqjpgjhrkngkks
mimmfuffffffffff		kngqiphtitgmhugf
mimmgfffffffffff		kngqmgmgfggnhihr
mimmggffffffffff		kngqftkokmiifrmo
mimmghffffffffff		kngqjqjmiglqhpii
mimmgiffffffffff		kngqglklhlhimjmk
mimmgjffffffffff		kngqknfhfmmqlhfr
mimmgkffffffffff		kngqlnlfgufilulo
mimmglffffffffff		kngqhqklhffukgfg
mimmgmffffffffff		kngqfjhhhhjqlqmf
mimmgnffffffffff		kngqkuilfrjrhpmr
mimmgoffffffffff		kngqlplmkhjjjrho
mimmgpffffffffff		kngqfgkglgkoimgh
mimmgqffffffffff		kngqkijqhtjoghgo
mimmgrffffffffff		kngqkkkqmihniiir
mimmgsffffffffff		kngqhpknfuifjogh
mimmgtffffffffff		kngqmmknfkisgjhh
mimmguffffffffff		kngqgmlkhlhpimlu
mimmhfffffffffff		kngqiuiugtinjkfo
mimmhgffffffffff		kngqinhhhhhkkpmp
mimmhhffffffffff		kngqjojilskglhkl
mimmhiffffffffff		kngqfoilgqilhqgg
mimmhjffffffffff		kngqmiilkijhlimp
mimmhkffffffffff		kngqfmlhlullkgfh
mimmhlffffffffff		kngqfffhfgjljljg
mimmhmffffffffff		kngqllhtjsirhkio
mimmhnffffffffff		kngqfpklfmkojifl
mimmhoffffffffff		kngqkofoljfolgjs
mimmhpffffffffff		kngqjghpfrmmjnln
mimmhqffffffffff		kngqfnfqlukiinmk
mimmhrffffffffff		kngqfkjklpmnktij
mimmhsffffffffff		kngqmrluhmkjjimf
mimmhtffffffffff		kngqhfkljqgfmtgl
mimmhuffffffffff		kngqholjkkmgllfq
mimmifffffffffff		kngqmjjtkmfgiiig
mimmigffffffffff		kngqiffllfhnmgkk
mimmihffffffffff		kngqhnlrglmlhthn
mimmiiffffffffff		kngqgolrjpfigjig
mimmijffffffffff		kngqimjigomgfplm
mimmikffffffffff		kngqggjulnkngpjh
mimmilffffffffff		kngqlmjgjslkihhq
mimmimffffffffff		kngqljlpirfnkrjn
mimminffffffffff		kngqfqipmsllksgi
mimmioffffffffff		kngqmulrkpffggik
mimmipffffffffff		kngqhljmghgrhiig
mimmiqffffffffff		kngqjrkihfkkhmjg
mimmirffffffffff		kngqgkkkmjkikpif
mimmisffffffffff		kngqgrgogrmumrlq
mimmitffffffffff		kngqhthmlfhlltgi
mimmiuffffffffff		kngqmsgjirhohfgt
mimmjfffffffffff		kngqgjkomugtjfms
mimmjgffffffffff		kngqhsgjffgngqfu
mimmjhffffffffff		kngqltipijgolomp
mimmjiffffffffff		kngqiifhktfjlpiu
mimmjjffffffffff		kngqjsifktkmgujo
mimmjkffffffffff		kngqhifphulmhtmh
mimmjlffffffffff		kngqithpfhhmlnff
mimmjmffffffffff		kngqhgknjmjphhhl
mimmjnffffffffff		kngqmqffgthiinfq
mimmjoffffffffff		kngqkjmhfujrfsfi
mimmjpffffffffff		kngqirmqktkpijmg
mimmjqffffffffff		kngqjkjfisfhkgkf
mimmjrffffffffff		kngqigfomsksmgin
mimmjsffffffffff		kngqlgjnlpikhuis
mimmjtffffffffff		kngqlsgtkijphulg
mimmjuffffffffff		kngqkfhkfjgigpit
mimmkfffffffffff		kngqfrgkhtkpgpmp
mimmkgffffffffff		kngqijisjpgkkfll
mimmkhffffffffff		kngqgsgojfgplpfq
mimmkiffffffffff		kngqgpjgfkguiffq
mimmkjffffffffff		kngqlfiliqigigji
mimmkkffffffffff		kngqkqgsislfjgjp
mimmklffffffffff		kngqgningggffuff
mimmkmffffffffff		kngqisfhfjkifgfi
mimmknffffffffff		kngqikktijjqlslh
mimmkoffffffffff		kngqflijkgkmkjfn
mimmkpffffffffff		kngqhjlthlhoklkq
mimmkqffffffffff		kngqiogtirfqmqii
mimmkrffffffffff		kngqgflglihqjglm
mimmksffffffffff		kngqfuiuhngmkohn
mimmktffffffffff		kngqgijkgngrjmll
mimmkuffffffffff		kngqmtiskoijjjfn
mimmlfffffffffff		kngqlufgmmmmgrmq
mimmlgffffffffff		kngqjjmkgrkqkqgq
mimmlhffffffffff		kngqiliifrklinmp
mimmliffffffffff		kngqlklkfkimjrhl
mimmljffffffffff		kngqhhgpfjjqlqir
mimmlkffffffffff		kngqguiqjnmkigjs
mimmllffffffffff		kngqghmgijhqlgkh
mimmlmffffffffff		kngqlqlogjhijihi
mimmlnffffffffff		kngqjhkpiifolmiq
mimmloffffffffff		kngqlhgjipmmghgh
mimmlpffffffffff		kngqmnhliqhslggk
mimmlqffffffffff		kngqjtgifuighkki
mimmlrffffffffff		kngqmlhhmiinhohg
mimmlsffffffffff		kngqkrinjjiilpju
mimmltffffffffff		kngqjufkjslmiujl
mimmluffffffffff		kngqjfmglsmnhfkj
mimmmfffffffffff		kngqkgmijogijmgn
mimmmgffffffffff		kngqlrfufujkftgo
mimmmhffffffffff		kngqloitlkmmlfkt
mimmmiffffffffff		kngqksftfkjlfimp
mimmmjffffffffff		kngqmoinkjgkmifi
mimmmkffffffffff		kngqfhiolngugfii
mimmmlffffffffff		kngqhrkfjpfffumm
mimmmmffffffffff		kngqhmgilmmqhmgj
mimmmnffffffffff		kngqfifrimkqknim
mimmmoffffffffff		kngqjmilligningq
mimmmpffffffffff		kngqfshpguihjggf
mimmmqffffffffff		kngqkmfskplrfflu
mimmmrffffffffff		kngqlilhgihjgjmi
mimmmsffffffffff		kngqkhmnkhknfpgr
mimmmtffffffffff		kngqgtggimhmlhlp
mimmmuffffffffff		kngqihfpkojhjjmu
